F       1, 1, 1      
C           232,211,2
WE ./path_to_the_west_texture      
NO ./path_to_the_north_texture  



SO ./path_to_the_south_texture  




EA   ./path_to_the_east_texture                 

                                                1111111111111111111111111   
                                                1000000000110000000000001 1
                                                1011000001110000000000001
                                                1001000000000000000000001 
                                                111111111011000001110000011111
                                                100000000011000001110111111111111
                                                11110111111111011100000010001
                                                11110111111111011101010010001
                                                11000000110101011100000010001
                                                10000000000000001100000010001
                                                1000000000000000110101001N001
                                                110000011101010111110111100111
                                                11110111 1110101 101111010011
                                                11111111 1111111 111111111111

